22222222222222222222222222222222
2       3             3        2
2       3      1      3        2
2    3333             3333     2
2                              2
2                              2
233333333333       3333333333332
2          3       3           2
2   444    3       3    444    2
2          3       3           2
2          33     33           2
2    5                   5     2
2                              2
2              44              2
2       33            33       2
2        3            3        2
2  5     3            3     5  2
2        3   5    5   3        2
2333333333            3333333332
2                              2
2       5      55      5       2
2                              2
2     3     44444444     3     2
2     3                  3     2
233333333              333333332
2       3      55      3       2
2   5   3              3   5   2
2                              2
22222222222222222222222222222222
