000000000000000000000000000000
022222222222222222220000000000
000000000000000000200000000000
000000000000000000200000000000
000000000000000000200000000000
000000000000000000200000000000
000000000000000000200000000000
000000000000000000200000000000
000000000000000000200000000000
000000000000000000200000000000
000020000000000000200000000000
000000000000000000200005000000
000020000000000000200005000000
000000000000000000200005000000
000000000000000000000005000000
000000000000000000000005000000
000020000000000000000005000000
000000000000000000000005000000
000020000000000000000005000000
000020000000000000000005000000
000020000000000000000005000000
000000000000000550505005500000
000000000000000000000000000000
000000000000000000000000000000
000000000000000000000000000000
000000000000000000000000000000
000000000000000000000000000000
000000000000000000000000000000
000000000000000000000000000000
000000000000000000000000000000
